XXXXXXXXXXXXXXXXXXXX
XP...............F.X
X..SSS...H.........X
X..SSS.............X
X..SSS.............X
X........F.........X
X............DDD...X
X..................X
X.....DD...........X
X..FFF.............X
X..................X
X.........HH.......X
X..................X
X..................X
X.....DD.......SS..X
X..................X
X..................X
X....S........HH...X
X........F........PX
XXXXXXXXXXXXXXXXXXXX