XXXXXXXXXXXXXXXXXXXXXXXXXXXXXXXXXXXXXXX
XP....................................X
X.....................................X
X..............XXXXXXXXX.............PX
X.....................................X
X.....................................X
X.................X...................X
X.......XXXXX.....X...................X
X.................X...................X
X.................X...................X
X.....................................X
XXXXXXXXXXXXXXXXXXXXXXXXXXXXXXXXXXXXXXX